W=9 H=9

TILES
.........
.........
.........
.....S...
.........
...!.....
.........
.........
.........

VERT
1001000101
1010000011
1000001101
1010010001
1000000101
1000110001
1100000001
1000010001
1000100011

HORZ
111111111
100001001
010010000
000000000
100101001
000101000
010000101
001010000
100100010
111111111