W=5 H=4

TILES
S....
.....
.....
....!

VERT
111111
100001
101101
111111

HORZ
11111
10001
10101
10001
11111